16,
8,
0,0,0,0,0,0,0,0,0,0,0,0,0,0,0,0
0,0,0,0,0,0,0,0,0,0,0,0,0,0,0,0
0,0,0,0,0,0,0,0,0,0,-1,0,0,0,0,-1,
0,0,0,0,0,0,0,0,0,-1,4,0,0,0,-1,4
0,0,0,0,0,0,0,0,-1,4,4,0,0,-1,4,4
0,0,0,0,0,0,0,-1,4,4,4,9,-1,4,4,4
1,2,2,2,3,0,1,2,2,2,2,2,2,2,2,2
7,5,5,5,6,0,7,5,5,5,5,5,5,5,5,6