0,0,0,0,0,0,0,0,0,0,0,0,0,0,
0,0,0,0,0,0,0,0,0,0,0,0,0,0,
0,0,0,0,0,0,0,0,0,0,0,0,0,0,
0,0,0,0,0,0,0,0,0,0,9,0,0,0,
0,0,9,0,0,0,0,0,0,4,4,4,4,0,
0,1,2,3,0,1,3,0,1,2,2,2,2,3,
0,7,5,6,0,7,6,0,7,5,5,5,5,6,
0,0,0,0,0,0,0,0,0,0,0,0,0,0,