0,0,0,0,0,0,0,0,0,0,0,0,0,0,
0,0,0,0,0,0,0,0,0,0,0,0,0,0,
0,0,0,0,0,4,4,4,4,0,0,0,0,0,
0,0,0,4,0,0,0,0,0,0,4,0,0,0,
0,0,4,4,0,0,0,0,0,0,4,4,0,0,
0,4,4,4,0,0,0,0,0,0,4,4,4,0,
1,2,2,2,3,0,0,0,1,2,2,2,2,3,
7,5,5,5,5,0,0,0,5,5,5,5,5,6,